dog	mammal
elephant	mammal
cat	mammal
cat	vehicle
cow	mammal
lion	mammal
pig	mammal
horse	mammal
bear	mammal
tiger	mammal
deer	mammal
robin	bird
sparrow	bird
pigeon	bird
chicken	bird
eagle	bird
duck	bird
owl	bird
penguin	bird
hawk	bird
crow	bird
cod	fish
goldfish	fish
minnow	fish
salmon	fish
trout	fish
tuna	fish
broccoli	vegetable
spinach	vegetable
lettuce	vegetable
potato	vegetable
onion	vegetable
carrot	vegetable
cucumber	vegetable
peas	vegetable
peas	fruit
celery	vegetable
beans	vegetable
beans	fruit
apple	fruit
apple	tree
orange	fruit
orange	tree
grape	fruit
peach	tree
peach	fruit
strawberry	fruit
plum	tree
plum	fruit
grapefruit	tree
grapefruit	fruit
oak	tree
pine	tree
birch	tree
cedar	tree
boat	vehicle
boat	dishware
car	vehicle
ship	vehicle
truck	vehicle
motorcycle	vehicle
helicopter	vehicle
bus	vehicle
aeroplane	vehicle
bicycle	vehicle
shirt	clothing
pants	clothing
socks	clothing
jacket	clothing
sweater	clothing
bra	clothing
skirt	clothing
skirt	bird
coat	clothing
dress	clothing
blouse	clothing
screwdriver	tool
hammer	tool
chisel	tool
wrench	tool
pliers	tool
cup	dishware
bowl	dishware
pan	kitchen_utensil
pot	kitchen_utensil
blender	kitchen_utensil